1111111111
1        1
1 22 222 1
1 2  2   1
12222222 1
1        1
1 222222 1
1     2  1
1 2 2 32 1
1111111111